{ 
	"id": 1,
	"name": "level 1",
	"w": 8,
	"h": 12,
	"tiles": [
		1, 1, 1, 1, 1, 1, 1, 1,
		1, 1, 1, 1, 1, 1, 1, 1,
		1, 1, 1, 1, 1, 1, 1, 1,
		3, 3, 3, 3, 1, 1, 1, 1,
		1, 1, 1, 1, 1, 1, 1, 1,
		1, 1, 1, 1, 1, 1, 1, 1,
		1, 1, 1, 1, 1, 1, 1, 1,
		1, 1, 1, 1, 1, 1, 1, 1,
		3, 3, 3, 3, 1, 1, 1, 1,
		1, 1, 1, 1, 1, 1, 1, 1,
		3, 3, 3, 3, 1, 1, 1, 1,
		1, 1, 1, 1, 1, 1, 1, 1

	],
	"altitude": [
		0,  0,  0,  0,  0,  0,  0,  0,
		0,  0,  0,  0,  0,  0,  0,  0,
		0,  0,  0,  0,  0,  0,  0,  0,
		0,  0,  0,  0,  0,  0,  0,  0,
		0,  0,  0,  0,  0,  0,  0,  0,
		0,  0,  0,  0,  0,  0,  0,  0,
		0,  0,  0,  0,  0,  0,  0,  0,
		0,  0,  0,  0,  0,  0,  0,  0,
		0,  0,  0,  0,  0,  0,  0,  0,
		0,  0,  0,  0,  0,  0,  0,  0,
		0,  0,  0,  0,  0,  0,  0,  0,
		0,  0,  0,  0,  0,  0,  0,  0

	]
}