{
	"description": "tiles.json contains height map information in 16 x 16 resolution for each tile.",
	"tiles": [
		{
			"id": 1,
			"name": "plain",
			"xoffset": -24,
			"yoffset": -17,
			"height_map": [
				0,0,0,0,0,0,0,0,0,0,0,0,0,0,0,0,
				0,0,0,0,0,0,0,0,0,0,0,0,0,0,0,0,
				0,0,0,0,0,0,0,0,0,0,0,0,0,0,0,0,
				0,0,0,0,0,0,0,0,0,0,0,0,0,0,0,0,
				0,0,0,0,0,0,0,0,0,0,0,0,0,0,0,0,
				0,0,0,0,0,0,0,0,0,0,0,0,0,0,0,0,
				0,0,0,0,0,0,0,0,0,0,0,0,0,0,0,0,
				0,0,0,0,0,0,0,0,0,0,0,0,0,0,0,0,
				0,0,0,0,0,0,0,0,0,0,0,0,0,0,0,0,
				0,0,0,0,0,0,0,0,0,0,0,0,0,0,0,0,
				0,0,0,0,0,0,0,0,0,0,0,0,0,0,0,0,
				0,0,0,0,0,0,0,0,0,0,0,0,0,0,0,0,
				0,0,0,0,0,0,0,0,0,0,0,0,0,0,0,0,
				0,0,0,0,0,0,0,0,0,0,0,0,0,0,0,0,
				0,0,0,0,0,0,0,0,0,0,0,0,0,0,0,0,
				0,0,0,0,0,0,0,0,0,0,0,0,0,0,0,0
			]
		},
		{
			"id": 2,
			"name": "slope right",
			"xoffset": -24,
			"yoffset": -17,
			"height_map": [
				0,-1,-2,-3,-4,-5,-6,-7,-8,-9,-10,-11,-12,-13,-14,-15,
				0,-1,-2,-3,-4,-5,-6,-7,-8,-9,-10,-11,-12,-13,-14,-15,
				0,-1,-2,-3,-4,-5,-6,-7,-8,-9,-10,-11,-12,-13,-14,-15,
				0,-1,-2,-3,-4,-5,-6,-7,-8,-9,-10,-11,-12,-13,-14,-15,
				0,-1,-2,-3,-4,-5,-6,-7,-8,-9,-10,-11,-12,-13,-14,-15,
				0,-1,-2,-3,-4,-5,-6,-7,-8,-9,-10,-11,-12,-13,-14,-15,
				0,-1,-2,-3,-4,-5,-6,-7,-8,-9,-10,-11,-12,-13,-14,-15,
				0,-1,-2,-3,-4,-5,-6,-7,-8,-9,-10,-11,-12,-13,-14,-15,
				0,-1,-2,-3,-4,-5,-6,-7,-8,-9,-10,-11,-12,-13,-14,-15,
				0,-1,-2,-3,-4,-5,-6,-7,-8,-9,-10,-11,-12,-13,-14,-15,
				0,-1,-2,-3,-4,-5,-6,-7,-8,-9,-10,-11,-12,-13,-14,-15,
				0,-1,-2,-3,-4,-5,-6,-7,-8,-9,-10,-11,-12,-13,-14,-15,
				0,-1,-2,-3,-4,-5,-6,-7,-8,-9,-10,-11,-12,-13,-14,-15,
				0,-1,-2,-3,-4,-5,-6,-7,-8,-9,-10,-11,-12,-13,-14,-15,
				0,-1,-2,-3,-4,-5,-6,-7,-8,-9,-10,-11,-12,-13,-14,-15,
				0,-1,-2,-3,-4,-5,-6,-7,-8,-9,-10,-11,-12,-13,-14,-15,
				0,-1,-2,-3,-4,-5,-6,-7,-8,-9,-10,-11,-12,-13,-14,-15
			]
		},
				{
			"name": "slope down",
			"xoffset": -24,
			"yoffset": -17,
			"height_map": [
				  0,  0,  0,  0,  0,  0,  0,  0,  0,  0,  0,  0,  0,  0,  0,  0,
				 -1, -1, -1, -1, -1, -1, -1, -1, -1, -1, -1, -1, -1, -1, -1, -1,
				 -2, -2, -2, -2, -2, -2, -2, -2, -2, -2, -2, -2, -2, -2, -2, -2,
				 -3, -3, -3, -3, -3, -3, -3, -3, -3, -3, -3, -3, -3, -3, -3, -3,
				 -4, -4, -4, -4, -4, -4, -4, -4, -4, -4, -4, -4, -4, -4, -4, -4,
				 -5, -5, -5, -5, -5, -5, -5, -5, -5, -5, -5, -5, -5, -5, -5, -5,
				 -6, -6, -6, -6, -6, -6, -6, -6, -6, -6, -6, -6, -6, -6, -6, -6,
				 -7, -7, -7, -7, -7, -7, -7, -7, -7, -7, -7, -7, -7, -7, -7, -7,
				 -8, -8, -8, -8, -8, -8, -8, -8, -8, -8, -8, -8, -8, -8, -8, -8,
				 -9, -9, -9, -9, -9, -9, -9, -9, -9, -9, -9, -9, -9, -9, -9, -9,
				-10,-10,-10,-10,-10,-10,-10,-10,-10,-10,-10,-10,-10,-10,-10,-10,
				-11,-11,-11,-11,-11,-11,-11,-11,-11,-11,-11,-11,-11,-11,-11,-11,
				-12,-12,-12,-12,-12,-12,-12,-12,-12,-12,-12,-12,-12,-12,-12,-12,
				-13,-13,-13,-13,-13,-13,-13,-13,-13,-13,-13,-13,-13,-13,-13,-13,
				-14,-14,-14,-14,-14,-14,-14,-14,-14,-14,-14,-14,-14,-14,-14,-14,
				-15,-15,-15,-15,-15,-15,-15,-15,-15,-15,-15,-15,-15,-15,-15,-15
			]
		}
	]
}