{ 
	"levels": [
		{ 
			"name": "level 1",
			"gridw": 14,
			"gridh": 12,
			"w":4,
			"h":5,
			"offset": 48,
			"tiles_old": [
				1,1,2,3,4,5,2,3,4,5,1,1,
				2,3,4,5,2,3,4,5,2,3,4,5,
				6,5,2,3,4,5,2,3,4,5,2,3,
				7,8,6,5,2,3,4,5,2,3,1,1	
			],
			"tiles": [
				1,1,   1,1,    2, 3,     4, 5,   1,1,   1,1,   1,1,
				1,1,   2,3,    4, 5,     2, 3,   4,5,   1,1,   1,1,
				2,3,   4,5,    2, 3,     4, 5,   2,3,   4,5,   1,1,
				4,5,   2,3,    4, 5,     2, 3,   4,5,   2,3,   4,5,
				1,8,   4,5,    2, 3,    11, 5,   2,3,   4,5,   2,3,
				1,1,   1,8,   10, 1,     1,12,  16,1,   1,8,  16,1,
				1,1,   1,1,    1,10,     2, 3,   4,5,   1,1,   1,1,
				1,1,   1,1,    1,13,     4, 5,   2,3,  16,1,   1,1,
				1,1,   1,1,   13, 1,     1,13,  16,1,   1,1,   1,1,
				1,1,   2,3,    4, 5,    13, 1,   1,1,   1,1,   1,1,
				1,8,   4,5,    2, 3,    16, 1,   1,1,   1,1,   1,1,
				1,1,   1,8,   16, 1,     1, 1,   1,1,   1,1,   1,1
			],
			"hmap": [
				100,100,100, 100,100,100, 100,100,100, 100,100,100,
				100,100,100, 100,100,100, 100,100,100, 100,100,100,
				100,100,100, 100,100,100, 100,100,100, 100,100,100,
				
				100,100,100, 100,100,100, 100,100,100,   0,  0,  0,
				100,100,100, 100,100,100, 100,100,100,   0,  0,  0,
				100,100,100, 100,100,100, 100,100,100,   0,  0,  0,
				
				100,100,100, 100,100,100,  90, 80, 70,  60, 60, 60,
				100,100,100, 100,100,100,  90, 80, 70,  60, 60, 60,
				100,100,100, 100,100,100,  90, 80, 70,  60, 60, 60,
				
				  0,  0,  0,   0,  0,  0,   0,  0,  0,  50, 50, 50,
				  0,  0,  0,   0,  0,  0,   0,  0,  0,  40, 40, 40,
				  0,  0,  0,   0,  0,  0,   0,  0,  0,  30, 30, 30,
				  
				  0,  0,  0,   0,  0,  0,   0,  0,  0,  20, 20, 20,
				  0,  0,  0,   0,  0,  0,   0,  0,  0,  20, 20, 20,
				  0,  0,  0,   0,  0,  0,   0,  0,  0,  20, 20, 20
			]
		}	
	]
}