{ 
	"levels":[
		{ 
			"name": "level 1",
			"width": 9,
			"data": [
				1, 1, 1, 1, 1, 1, 1, 1, 1,
				1, 6, 0, 0, 0, 1, 0, 0, 1,
				1, 0, 0, 5, 0, 0, 0, 5, 1,
				1, 5, 0, 0, 6, 1, 0, 0, 1,
				1, 1, 1, 1, 1, 1, 1, 1, 1
			]
		},
		
		{ 
			"name": "level 2",
			"width": 6,
			"data": [
				1, 1, 1, 0, 1, 1,
				1, 0, 1, 1, 0, 1,
				1, 0, 0, 0, 0, 1,
				1, 0, 1, 1, 0, 1,
				1, 1, 1, 0, 1, 1	
			]
		},
		
		{ 
			"name": "level 3",
			"width": 6,
			"data": [
				1, 1, 1, 0, 1, 1,
				1, 0, 1, 1, 0, 1,
				1, 0, 0, 0, 0, 1,
				1, 0, 1, 1, 0, 1,
				1, 1, 1, 0, 1, 1	
			]
		}	
	]
}