{ 
	"levels":[
		{ 
			"name": "level 1",
			"width": 18,
			"data": [
				1, 1, 1, 1, 1, 1, 1, 1, 1, 1, 1, 1, 1, 1, 1, 1, 1, 1,
				1, 0, 0, 0, 0, 1, 0, 0, 1, 0, 0, 0, 0, 0, 1, 0, 0, 1,
				1, 0, 0, 0, 0, 1, 0, 0, 1, 0, 0, 0, 0, 0, 0, 0, 0, 1,
				1, 0, 0, 0, 0, 0, 0, 0, 0, 0, 0, 0, 0, 0, 1, 0, 0, 1,
				1, 0, 1, 1, 1, 1, 0, 0, 1, 1, 1, 1, 1, 0, 1, 0, 0, 1,
				1, 0, 0, 0, 0, 0, 0, 0, 1, 0, 0, 0, 0, 0, 0, 0, 0, 1,
				1, 0, 0, 0, 0, 1, 0, 0, 1, 0, 0, 0, 0, 0, 1, 1, 0, 1,
				1, 0, 0, 0, 0, 1, 0, 0, 1, 0, 0, 0, 0, 0, 1, 0, 0, 1,
				1, 0, 0, 0, 0, 1, 0, 0, 0, 0, 0, 0, 0, 0, 1, 0, 0, 1,
				1, 0, 0, 0, 0, 1, 0, 0, 1, 1, 0, 0, 0, 0, 1, 0, 0, 1,
				1, 1, 1, 1, 1, 1, 1, 1, 1, 1, 1, 1, 1, 1, 1, 1, 1, 1
			],
			"beings": [
				{"class": "snake", "pos": [ 4, 4] },
				{"class": "snake", "pos": [ 3, 8] },
				{"class": "snake", "pos": [11, 8] },
				{"class": "gold" , "pos": [ 7, 2] },
				{"class": "gold" , "pos": [17,10] }
			]
		},
		
		{ 
			"name": "level 2",
			"width": 6,
			"data": [
				1, 1, 1, 0, 1, 1,
				1, 0, 1, 1, 0, 1,
				1, 0, 0, 0, 0, 1,
				1, 0, 1, 1, 0, 1,
				1, 1, 1, 0, 1, 1	
			],
			"beings": [
				{"class": "snake", "pos": [2,4]}
			]

		},
		
		{ 
			"name": "level 3",
			"width": 6,
			"data": [
				1, 1, 1, 0, 1, 1,
				1, 0, 1, 1, 0, 1,
				1, 0, 0, 0, 0, 1,
				1, 0, 1, 1, 0, 1,
				1, 1, 1, 0, 1, 1	
			],
			"beings": [
				{"class": "snake", "pos": [2,4]}
			]
		}	
	]
}