{ "levels":[
	{ "name": "level 1",
	"width": 6,
	"data": [
		1, 1, 1, 1, 1, 1,
		1, 0, 0, 0, 0, 1,
		1, 0, 0, 0, 0, 1,
		1, 0, 0, 0, 0, 1,
		1, 1, 1, 1, 1, 1
	]},
	
	{ "name": "level 2",
	"width": 6,
	"data": [
		1, 1, 1, 0, 1, 1,
		1, 0, 1, 1, 0, 1,
		1, 0, 0, 0, 0, 1,
		1, 0, 1, 1, 0, 1,
		1, 1, 1, 0, 1, 1	
	]
	}
]}